//MAP CONVERTED BY dmm2tgm.py THIS HEADER COMMENT PREVENTS RECONVERSION, DO NOT REMOVE
"a" = (
/turf/open/transparent/openspace,
/area/rogue/outdoors/bograt/above)
"b" = (
/turf/open/water/river{
	dir = 1;
	icon_state = "rockwd"
	},
/area/rogue/under/cavewet/river)
"c" = (
/turf/open/water/river{
	dir = 4;
	icon_state = "rockwd"
	},
/area/rogue/under/cavewet/river)
"d" = (
/obj/structure/flora/roguegrass/water/reeds,
/turf/open/water/river{
	dir = 4;
	icon_state = "rockwd"
	},
/area/rogue/under/cavewet/river)
"e" = (
/turf/closed/mineral/random/rogue,
/area/rogue/under/cavewet)
"g" = (
/turf/open/floor/rogue/dirt,
/area/rogue/under/cavewet/river)
"h" = (
/turf/open/water/river{
	icon_state = "rockwd"
	},
/area/rogue/under/cavewet/river)
"j" = (
/turf/closed/wall/mineral/rogue/stone/moss,
/area/rogue/outdoors/bograt/north)
"k" = (
/turf/open/transparent/openspace,
/area/rogue/outdoors/rtfield/rockhill)
"l" = (
/turf/closed/mineral/random/rogue,
/area/rogue/under/cavewet/river)
"o" = (
/turf/open/floor/rogue/cobble/mossy,
/area/rogue/outdoors/rtfield/rockhill)
"r" = (
/turf/open/floor/rogue/dirt/road,
/area/rogue/outdoors/rtfield/rockhill)
"t" = (
/turf/open/floor/rogue/dirt,
/area/rogue/outdoors/bograt/north)
"u" = (
/obj/structure/flora/roguetree/burnt,
/turf/open/floor/rogue/dirt/road,
/area/rogue/outdoors/rtfield/rockhill)
"v" = (
/turf/open/floor/rogue/cobblerock,
/area/rogue/outdoors/rtfield/rockhill)
"w" = (
/turf/open/floor/rogue/grass,
/area/rogue/outdoors/rtfield/rockhill)
"y" = (
/obj/machinery/light/rogue/firebowl/stump,
/turf/open/floor/rogue/dirt/road,
/area/rogue/outdoors/bograt/north)
"z" = (
/obj/machinery/light/rogue/firebowl/standing/blue,
/turf/open/floor/rogue/naturalstone,
/area/rogue/under/cavewet)
"A" = (
/turf/open/floor/rogue/blocks/platform,
/area/rogue/outdoors/bograt/above)
"B" = (
/turf/open/floor/rogue/cobblerock,
/area/rogue/outdoors/bograt/north)
"E" = (
/obj/structure/flora/rogueshroom{
	icon_state = "mush2"
	},
/turf/open/floor/rogue/dirt/road,
/area/rogue/under/cavewet)
"J" = (
/turf/open/floor/rogue/dirt/road,
/area/rogue/under/cavewet)
"K" = (
/turf/open/floor/rogue/cobble/mossy,
/area/rogue/outdoors/bograt/north)
"L" = (
/obj/structure/flora/roguegrass/water/reeds,
/turf/closed/mineral/random/rogue,
/area/rogue/under/cavewet/river)
"O" = (
/obj/structure/flora/roguetree,
/turf/open/floor/rogue/grass,
/area/rogue/outdoors/rtfield/rockhill)
"Q" = (
/turf/open/floor/rogue/dirt,
/area/rogue/under/cavewet)
"R" = (
/obj/structure/flora/roguetree/burnt,
/turf/open/floor/rogue/dirt,
/area/rogue/outdoors/rtfield/rockhill)
"T" = (
/turf/open/floor/rogue/naturalstone,
/area/rogue/under/cavewet)
"V" = (
/turf/open/transparent/openspace,
/area/rogue/outdoors/rtfield/rockhill/above)
"X" = (
/turf/open/floor/rogue/dirt/road,
/area/rogue/outdoors/bograt/north)
"Y" = (
/turf/open/floor/rogue/dirt,
/area/rogue/outdoors/rtfield/rockhill)

(1,1,1) = {"
T
T
J
e
h
h
c
c
c
c
b
Q
e
J
J
"}
(2,1,1) = {"
T
T
J
e
l
l
c
c
L
c
l
e
e
J
J
"}
(3,1,1) = {"
e
E
J
Q
c
b
b
c
g
h
c
e
Q
J
T
"}
(4,1,1) = {"
e
e
Q
Q
c
g
g
d
g
g
c
Q
Q
J
z
"}
(5,1,1) = {"
e
e
Q
Q
c
l
l
c
l
l
c
Q
Q
J
e
"}
(6,1,1) = {"
e
e
e
Q
c
g
g
c
g
g
h
c
Q
e
e
"}
(7,1,1) = {"
e
e
e
e
c
l
g
c
g
g
l
c
Q
e
e
"}
(8,1,1) = {"
e
e
e
e
d
l
l
d
c
l
L
c
e
e
e
"}
(9,1,1) = {"
e
e
e
e
c
d
d
c
c
d
c
c
e
e
e
"}

(1,1,2) = {"
w
r
Y
Y
Y
k
k
k
k
k
t
t
j
t
X
"}
(2,1,2) = {"
r
w
r
r
r
r
R
Y
r
Y
t
t
X
y
B
"}
(3,1,2) = {"
v
o
v
v
v
r
v
r
r
v
B
B
B
B
X
"}
(4,1,2) = {"
o
o
v
r
v
v
v
v
o
o
B
X
B
B
K
"}
(5,1,2) = {"
v
v
v
v
v
o
o
v
v
v
B
K
K
X
B
"}
(6,1,2) = {"
o
o
o
v
v
r
v
v
o
r
K
B
B
B
X
"}
(7,1,2) = {"
v
v
v
r
v
v
v
v
r
o
K
K
K
B
B
"}
(8,1,2) = {"
r
r
r
r
Y
Y
r
r
Y
Y
u
t
X
y
B
"}
(9,1,2) = {"
O
r
Y
Y
r
k
k
k
k
k
Y
t
j
X
X
"}

(1,1,3) = {"
V
V
V
V
V
V
V
V
V
V
a
a
A
a
a
"}
(2,1,3) = {"
V
V
V
V
V
V
V
V
V
V
a
a
a
a
a
"}
(3,1,3) = {"
V
V
V
V
V
V
V
V
V
V
a
a
a
a
a
"}
(4,1,3) = {"
V
V
V
V
V
V
V
V
V
V
a
a
a
a
a
"}
(5,1,3) = {"
V
V
V
V
V
V
V
V
V
V
a
a
a
a
a
"}
(6,1,3) = {"
V
V
V
V
V
V
V
V
V
V
a
a
a
a
a
"}
(7,1,3) = {"
V
V
V
V
V
V
V
V
V
V
a
a
a
a
a
"}
(8,1,3) = {"
V
V
V
V
V
V
V
V
V
V
V
a
a
a
a
"}
(9,1,3) = {"
V
V
V
V
V
V
V
V
V
V
V
a
A
a
a
"}

(1,1,4) = {"
V
V
V
V
V
V
V
V
V
V
a
a
a
a
a
"}
(2,1,4) = {"
V
V
V
V
V
V
V
V
V
V
a
a
a
a
a
"}
(3,1,4) = {"
V
V
V
V
V
V
V
V
V
V
a
a
a
a
a
"}
(4,1,4) = {"
V
V
V
V
V
V
V
V
V
V
a
a
a
a
a
"}
(5,1,4) = {"
V
V
V
V
V
V
V
V
V
V
a
a
a
a
a
"}
(6,1,4) = {"
V
V
V
V
V
V
V
V
V
V
a
a
a
a
a
"}
(7,1,4) = {"
V
V
V
V
V
V
V
V
V
V
a
a
a
a
a
"}
(8,1,4) = {"
V
V
V
V
V
V
V
V
V
V
V
a
a
a
a
"}
(9,1,4) = {"
V
V
V
V
V
V
V
V
V
V
V
a
a
a
a
"}

(1,1,5) = {"
V
V
V
V
V
V
V
V
V
V
a
a
a
a
a
"}
(2,1,5) = {"
V
V
V
V
V
V
V
V
V
V
a
a
a
a
a
"}
(3,1,5) = {"
V
V
V
V
V
V
V
V
V
V
a
a
a
a
a
"}
(4,1,5) = {"
V
V
V
V
V
V
V
V
V
V
a
a
a
a
a
"}
(5,1,5) = {"
V
V
V
V
V
V
V
V
V
V
a
a
a
a
a
"}
(6,1,5) = {"
V
V
V
V
V
V
V
V
V
V
a
a
a
a
a
"}
(7,1,5) = {"
V
V
V
V
V
V
V
V
V
V
a
a
a
a
a
"}
(8,1,5) = {"
V
V
V
V
V
V
V
V
V
V
V
a
a
a
a
"}
(9,1,5) = {"
V
V
V
V
V
V
V
V
V
V
V
a
a
a
a
"}
