//MAP CONVERTED BY dmm2tgm.py THIS HEADER COMMENT PREVENTS RECONVERSION, DO NOT REMOVE
"a" = (
/turf/open/transparent/openspace,
/area/rogue/outdoors/bograt/above)
"b" = (
/turf/open/water/river{
	dir = 1;
	icon_state = "rockwd"
	},
/area/rogue/under/cavewet/river)
"c" = (
/turf/open/water/river{
	dir = 4;
	icon_state = "rockwd"
	},
/area/rogue/under/cavewet/river)
"d" = (
/obj/structure/flora/roguegrass/water/reeds,
/turf/open/water/river{
	dir = 4;
	icon_state = "rockwd"
	},
/area/rogue/under/cavewet/river)
"e" = (
/turf/closed/mineral/random/rogue,
/area/rogue/under/cavewet)
"g" = (
/turf/open/floor/rogue/dirt,
/area/rogue/under/cavewet/river)
"h" = (
/turf/open/water/river{
	icon_state = "rockwd"
	},
/area/rogue/under/cavewet/river)
"i" = (
/obj/effect/landmark/events/haunts,
/turf/open/floor/rogue/cobblerock,
/area/rogue/outdoors/rtfield/rockhill)
"j" = (
/turf/closed/wall/mineral/rogue/stone/moss,
/area/rogue/outdoors/bograt/north)
"k" = (
/turf/open/transparent/openspace,
/area/rogue/outdoors/rtfield/rockhill)
"l" = (
/obj/structure/stairs/stone,
/obj/structure/fluff/railing/border{
	dir = 10
	},
/turf/open/floor/rogue/cobble,
/area/rogue/outdoors/rtfield/rockhill)
"m" = (
/obj/structure/fluff/railing/border{
	dir = 4
	},
/turf/open/floor/rogue/cobble,
/area/rogue/outdoors/bograt/north)
"n" = (
/obj/structure/stairs/stone,
/obj/structure/fluff/railing/border{
	dir = 6
	},
/turf/open/floor/rogue/cobble,
/area/rogue/outdoors/rtfield/rockhill)
"o" = (
/turf/open/floor/rogue/cobble/mossy,
/area/rogue/outdoors/rtfield/rockhill)
"q" = (
/turf/open/floor/rogue/blocks/platform,
/area/rogue/outdoors/rtfield/rockhill)
"r" = (
/turf/open/floor/rogue/dirt/road,
/area/rogue/outdoors/rtfield/rockhill)
"t" = (
/turf/open/floor/rogue/dirt,
/area/rogue/outdoors/bograt/north)
"u" = (
/turf/closed/wall/mineral/rogue/stone/moss,
/area/rogue/under/cavewet)
"v" = (
/turf/open/floor/rogue/cobblerock,
/area/rogue/outdoors/rtfield/rockhill)
"w" = (
/turf/open/floor/rogue/grass,
/area/rogue/outdoors/rtfield/rockhill)
"x" = (
/turf/closed/wall/mineral/rogue/stone,
/area/rogue/under/cavewet/river)
"y" = (
/obj/machinery/light/rogue/firebowl/stump,
/turf/open/floor/rogue/dirt/road,
/area/rogue/outdoors/bograt/north)
"z" = (
/obj/machinery/light/rogue/firebowl/standing/blue,
/turf/open/floor/rogue/naturalstone,
/area/rogue/under/cavewet)
"A" = (
/turf/open/floor/rogue/blocks/platform,
/area/rogue/outdoors/bograt/north)
"B" = (
/turf/open/floor/rogue/cobblerock,
/area/rogue/outdoors/bograt/north)
"C" = (
/obj/structure/stairs/stone{
	dir = 1
	},
/obj/structure/fluff/railing/border{
	dir = 5
	},
/turf/open/floor/rogue/cobble,
/area/rogue/outdoors/bograt/north)
"E" = (
/obj/structure/flora/rogueshroom{
	icon_state = "mush2"
	},
/turf/open/floor/rogue/dirt/road,
/area/rogue/under/cavewet)
"F" = (
/obj/structure/stairs/stone{
	dir = 1
	},
/turf/open/floor/rogue/cobble,
/area/rogue/outdoors/bograt/north)
"G" = (
/turf/open/floor/rogue/blocks/platform,
/area/rogue/outdoors/bograt/above)
"H" = (
/obj/structure/fluff/railing/border{
	dir = 8
	},
/turf/open/floor/rogue/cobble,
/area/rogue/outdoors/rtfield/rockhill)
"I" = (
/turf/open/transparent/openspace,
/area/rogue/outdoors/bograt/north)
"J" = (
/turf/open/floor/rogue/dirt/road,
/area/rogue/under/cavewet)
"K" = (
/turf/open/floor/rogue/cobble/mossy,
/area/rogue/outdoors/bograt/north)
"L" = (
/obj/structure/flora/roguegrass/water/reeds,
/turf/open/water/river{
	dir = 1;
	icon_state = "rockwd"
	},
/area/rogue/under/cavewet/river)
"M" = (
/obj/structure/fluff/railing/border{
	dir = 8
	},
/turf/open/floor/rogue/cobble,
/area/rogue/outdoors/bograt/north)
"N" = (
/obj/structure/stairs/stone{
	dir = 1
	},
/obj/structure/fluff/railing/border{
	dir = 9
	},
/turf/open/floor/rogue/cobble,
/area/rogue/outdoors/bograt/north)
"O" = (
/obj/structure/flora/roguetree,
/turf/open/floor/rogue/grass,
/area/rogue/outdoors/rtfield/rockhill)
"P" = (
/obj/structure/stairs/stone,
/turf/open/floor/rogue/cobble,
/area/rogue/outdoors/rtfield/rockhill)
"Q" = (
/turf/open/floor/rogue/dirt,
/area/rogue/under/cavewet)
"R" = (
/turf/open/floor/rogue/cobble,
/area/rogue/outdoors/bograt/north)
"S" = (
/obj/structure/fluff/railing/border{
	dir = 4
	},
/turf/open/floor/rogue/cobble,
/area/rogue/outdoors/rtfield/rockhill)
"T" = (
/turf/open/floor/rogue/naturalstone,
/area/rogue/under/cavewet)
"V" = (
/turf/open/transparent/openspace,
/area/rogue/outdoors/rtfield/rockhill/above)
"W" = (
/turf/open/floor/rogue/cobble,
/area/rogue/outdoors/rtfield/rockhill)
"X" = (
/turf/open/floor/rogue/dirt/road,
/area/rogue/outdoors/bograt/north)
"Y" = (
/turf/open/floor/rogue/dirt,
/area/rogue/outdoors/rtfield/rockhill)

(1,1,1) = {"
T
T
J
u
c
c
c
c
c
c
c
Q
Q
J
J
"}
(2,1,1) = {"
T
T
J
u
c
c
c
c
L
h
c
Q
Q
J
J
"}
(3,1,1) = {"
e
E
J
J
c
c
c
c
g
x
c
Q
Q
J
T
"}
(4,1,1) = {"
e
e
J
J
c
c
g
d
g
g
c
Q
Q
J
z
"}
(5,1,1) = {"
e
e
e
e
c
c
c
c
c
c
c
Q
Q
J
e
"}
(6,1,1) = {"
e
e
e
e
c
b
c
c
c
b
c
c
Q
e
e
"}
(7,1,1) = {"
e
e
e
e
c
x
g
c
c
x
c
c
Q
e
e
"}
(8,1,1) = {"
e
e
e
e
d
g
g
d
c
g
d
c
e
e
e
"}
(9,1,1) = {"
e
e
e
e
c
d
d
c
c
d
c
c
e
e
e
"}

(1,1,2) = {"
w
r
r
Y
k
k
k
k
k
k
I
t
j
t
X
"}
(2,1,2) = {"
r
w
Y
Y
k
k
k
k
k
k
I
t
X
y
B
"}
(3,1,2) = {"
v
l
H
H
W
k
k
k
k
W
M
M
M
N
B
"}
(4,1,2) = {"
v
P
W
q
k
k
k
W
W
W
R
R
A
F
K
"}
(5,1,2) = {"
i
P
W
W
W
k
W
W
k
W
R
A
R
F
B
"}
(6,1,2) = {"
o
P
q
W
W
W
W
k
k
k
R
A
R
F
B
"}
(7,1,2) = {"
v
n
S
S
S
S
k
k
k
W
R
m
m
C
B
"}
(8,1,2) = {"
r
r
r
r
k
k
k
k
k
k
k
I
X
y
B
"}
(9,1,2) = {"
O
r
Y
r
k
k
k
k
k
k
k
I
j
X
X
"}

(1,1,3) = {"
V
V
V
V
V
V
V
V
V
V
a
a
G
a
a
"}
(2,1,3) = {"
V
V
V
V
V
V
V
V
V
V
a
a
a
a
a
"}
(3,1,3) = {"
V
V
V
V
V
V
V
V
V
V
a
a
a
a
a
"}
(4,1,3) = {"
V
V
V
V
V
V
V
V
V
V
a
a
a
a
a
"}
(5,1,3) = {"
V
V
V
V
V
V
V
V
V
V
a
a
a
a
a
"}
(6,1,3) = {"
V
V
V
V
V
V
V
V
V
V
a
a
a
a
a
"}
(7,1,3) = {"
V
V
V
V
V
V
V
V
V
V
a
a
a
a
a
"}
(8,1,3) = {"
V
V
V
V
V
V
V
V
V
V
V
a
a
a
a
"}
(9,1,3) = {"
V
V
V
V
V
V
V
V
V
V
V
a
G
a
a
"}

(1,1,4) = {"
V
V
V
V
V
V
V
V
V
V
a
a
a
a
a
"}
(2,1,4) = {"
V
V
V
V
V
V
V
V
V
V
a
a
a
a
a
"}
(3,1,4) = {"
V
V
V
V
V
V
V
V
V
V
a
a
a
a
a
"}
(4,1,4) = {"
V
V
V
V
V
V
V
V
V
V
a
a
a
a
a
"}
(5,1,4) = {"
V
V
V
V
V
V
V
V
V
V
a
a
a
a
a
"}
(6,1,4) = {"
V
V
V
V
V
V
V
V
V
V
a
a
a
a
a
"}
(7,1,4) = {"
V
V
V
V
V
V
V
V
V
V
a
a
a
a
a
"}
(8,1,4) = {"
V
V
V
V
V
V
V
V
V
V
V
a
a
a
a
"}
(9,1,4) = {"
V
V
V
V
V
V
V
V
V
V
V
a
a
a
a
"}

(1,1,5) = {"
V
V
V
V
V
V
V
V
V
V
a
a
a
a
a
"}
(2,1,5) = {"
V
V
V
V
V
V
V
V
V
V
a
a
a
a
a
"}
(3,1,5) = {"
V
V
V
V
V
V
V
V
V
V
a
a
a
a
a
"}
(4,1,5) = {"
V
V
V
V
V
V
V
V
V
V
a
a
a
a
a
"}
(5,1,5) = {"
V
V
V
V
V
V
V
V
V
V
a
a
a
a
a
"}
(6,1,5) = {"
V
V
V
V
V
V
V
V
V
V
a
a
a
a
a
"}
(7,1,5) = {"
V
V
V
V
V
V
V
V
V
V
a
a
a
a
a
"}
(8,1,5) = {"
V
V
V
V
V
V
V
V
V
V
V
a
a
a
a
"}
(9,1,5) = {"
V
V
V
V
V
V
V
V
V
V
V
a
a
a
a
"}
